#########
# OX# OX#
# #1# #2#
#   #   #
#########
